Once - однажды 
Magnificent - блестящий, восхитительный 
Primeval - первобытный
Boa - удав
Swallow - глотать
Prey - добыча
Whole - целиком
Chew - жевать
Able - в состоянии
Through - по причине
Digestion - пищеварение
It looked like this - это выглядело так 
Masterpiece - шедевр
Grow-up - взрослые
Whether - ли
Clearly - ясно, очевидно
Advised - посоветовали
Disheartened - приходить в уныние, обескуражен
Failure - провал
by themselves - сами по себе
tiresome - утомительно
Queue - очередь
Access - доступ
Unique - уникальный
assigned - назначенный 
distinguish - различать
improve - улучшать
until - до тех пор
sailor - моряк 
imagine - воображать
amazement - изумление
awaken - разбудить
odd - странный
examine - иследовать
thirsty - жажда 
frighten - пугать
disobey - ослушаться
ram - баран
reject - отклонить
patience - терпение
exhaust - Исчерпать
judge - эксперт
exactly - точно
fan - вентилятор
consumption - потребление
preserve  - сохранять
access - доступ
management - управление
capabilities - возможность  
system logging - ведение системного журнала
ensures - гарантировать
bandwidth - пропускная способность 
available - доступный 
converter - преобразователь 
frightened - испуганный 
advise - объяснять 
useful - полезна 
seem - выглядеть
disobey - ослушаться 
gently - нежно
complicated - сложно 
modestly - скромно
irritate - раздражать 
presence - присутсвовать 
demand - потребовал
abruptly - резко
toss - бросать
far - далеко
curiosity - интерес
tie - веревка 
post - столб
wander - бродить 
loudly - громко
earnestly - серьезно
believe - полагать 
instead - вместо
charming - очаровательный
handler - обработчик 
Layout - макет 
destination - назначение 
extensible - расширяемый
bound -граница, связывать 
sophisticated - сложный
verbose - подробный 
deployment - развертывание
resolving -  разрешение
ability - возможность 
interceptors - перехватчик
Thus - итак 
approach - подход
significant - сущесвенный
additionally - дополнительно
Unfortunately - к несчастью 
pretty common - довольно распространенный 